000000000000000000000000000000000000000000000000001FFFFFFFFFFC00001FFFFFFFFFFC00001FFFFFFFFFFC00001FFFFFFFFFFC00001FFFFFFFFFFC00
001FFFFFFFFFFC0000000007C000000000000007C000000000000007C000000000000007C000000000000007C000000000000007C000000000000007C0000000
00000007C000000000000007C000000000000007C000000000000007C000000000000007C000000000000007C000000000000007C0000000001FFFFFFFFFFC00
001FFFFFFFFFFC00001FFFFFFFFFFC00001FFFFFFFFFFC00001FFFFFFFFFFC00001FFFFFFFFFFC00000000000000000000000000000000000000000000000000
000000000000000000000000000000000000000000000000000000003FFC000000000000FFFF000000000003FFFF800000000007FFFFC0000000000FFFFFE000
0000001FEF0FF0000000001F8F03F8000000003F0F00F8000000003E0F00FC000000003C0F007C000000007C0F007C000000007C0F003C000000007C0F003C00
0000007C0F003C000000007C0F003C000000007C0F007C000000003C0F007C000000003E0F007C000000003F0F00F8000000001FFF03F8000000001FFF0FF000
0000000FFF0FF00000000007FF0FE00000000001FF0F8000000000007F0F00000000000000000000000000000000000000000000000000000000000000000000
00000000000000000000000000000000000000000000000000000000000000000000000000000000000000000000000000000000000000000000000000000000
00000000000000000000000000000000000000000000000000000000000000000000000000000000001FFFFFFFFFFC00001FFFFFFFFFFC00001FFFFFFFFFFC00
001FFFFFFFFFFC00001FFFFFFFFFFC00000000000000000000000000000000000000000000000000000000000000000000000000000000000000000000000000
00000000000000000000000000000000000000000000000000000000000000000000000000000000000000000000000000000000000000000000000000000000
00000000000000000000000000000000000000000000000000000000000000000000000000000000000000000000000000000000000000000000000000000000
00000000000000000000000000000000000000000000000000000000000000000000000000000000001FFFFFFFFFFC00001FFFFFFFFFFC00001FFFFFFFFFFC00
001FFFFFFFFFFC00001FFFFFFFFFFC00000000000000000000000000000000000000000000000000000000000000000000000000000000000000000000000000
00000000000000000000000000000000000000000000000000000000000000000000000000000000000000000000000000000000000000000000000000000000
000000000000000000000000000000000000000007E00000000000007FFC000000000001FFFF000000000003FFFF800000000007FFFFC0000000000FFFFFE000
0000001FE00FF0000000001F8003F8000000003F0001F8000000003E0000FC000000003E00007C000000007C00007C000000007C00003C000000007C00003C00
0000007C00003C000000007C00003C000000003C00007C000000003E00007C000000003F0000F8000000001F8001F8000000001FC003F0000000000FF81FF000
00000007FFFFE00000000003FFFFC00000000001FFFF800000000000FFFE0000000000001FF80000000000000000000000000000000000000000000000000000
00000000000000000000000000000000000000000000000000000000000000000000000000000000000000000000000000000000000000000000000000000000
00000000000000000000000000000000000000000000000000000000000000000000000000000000000000000000000000000000000000000000000000000000
00000000000000000000000000000000000000000000000000000000000000000000000000000000000000000000000000000000000000000000000000000000
00000000000000000000000000000000000000000000000000000000000000000000000000000000000000000000000000000000000000000000000000000000
0018000000000000001FF80000000000001FFFF800000000001FFFFFF8000000001FFFFFFFF00000001FFFFFFFFFF00000003FFFFFFFFC000000000FFFFFFC00
0000000003FFFC00000000001FFFFC000000001FFFFFFC0000000FFFFFFF80000007FFFFFFC00000001FFFFFE0000000001FFFF000000000001FFC0000000000
001FFFF000000000001FFFFFE00000000007FFFFFFC0000000000FFFFFFF80000000001FFFFFFC00000000001FFFFC000000000003FFFC000000000FFFFFFC00
00003FFFFFFFFC00001FFFFFFFFFF000001FFFFFFFF00000001FFFFFF8000000001FFFF800000000001FF8000000000000180000000000000000000000000000
000000000000000000000000000000000000000007E00000000000007FFC000000000001FFFF000000000003FFFF800000000007FFFFC0000000000FFFFFE000
0000001FE00FF0000000001F8003F8000000003F0001F8000000003E0000FC000000003E00007C000000007C00007C000000007C00003C000000007C00003C00
0000007C00003C000000007C00003C000000003C00007C000000003E00007C000000003F0000F8000000001F8001F8000000001FC003F0000000000FF81FF000
00000007FFFFE00000000003FFFFC00000000001FFFF800000000000FFFE0000000000001FF80000000000000000000000000000000000000000000000000000
0000000000000000000000000000000000000000000000000000000000000000000000000000000000000000000000000000003FFFFFFC000000003FFFFFFC00
0000003FFFFFFC000000003FFFFFFC000000003FFFFFFC000000003FFFFFFC0000000001F800000000000003F000000000000007C00000000000000F80000000
0000001F000000000000001F000000000000003E000000000000003E000000000000003E000000000000003E000000000000007E000000000000007E00000000
0000007E000000000000000000000000000000000000000000000000000000000000000000000000000000000000000000000000000000000000000000000000
00000000000000000000000000000000000000000000000000000000000000000000000000000000000000000000000000000000000000000000000000000000
00000000000000000000000000000000000000000000000000000000000000000000000000000000001FFFFFFFFFFC00001FFFFFFFFFFC00001FFFFFFFFFFC00
001FFFFFFFFFFC00001FFFFFFFFFFC00000000000000000000000000000000000000000000000000000000000000000000000000000000000000000000000000
00000000000000000000000000000000000000000000000000000000000000000000000000000000000000000000000000000000000000000000000000000000
00000000000000000000000000000000000000000FE0000000000000FFFE000000000003FFFF800000000007FFFFC0000000000FFFFFE0000000001FFFFFF000
0000001FE007F8000000003F0001F8000000003E0000FC000000007C00007C000000007C00007C000000007C00003C000000007C00003C000000007C00003C00
0000007C00003C000000007C00007C000000003C000078000000003E0000F8000000001F0001F0000000000FC007E000001FFFFFFFFFFC00001FFFFFFFFFFC00
001FFFFFFFFFFC00001FFFFFFFFFFC00001FFFFFFFFFFC00001FFFFFFFFFFC000000000000000000000000000000000000000000000000000000000000000000
0000000000000000000008010000000000003801C00000000000FC03F00000000000FC03F000000000007E07E000000000003E07C000000000003F0FC0000000
00001F0F8000000000000F9F0000000000000F9F00000000000007FE00000000000003FC00000000002003FC00000000003FFFFFFFC00000003FFFFFFFC00000
003FFFFFFFC00000003FFFFFFFC00000002003FC00000000000003FC00000000000007FE0000000000000F9F0000000000000F9F0000000000001F0F80000000
00003F0FC000000000003E07C000000000007E07E00000000000FC03F00000000000FC03F000000000003801C000000000000801000000000000000000000000
00000000000000000000000000000000000000000000000000000000000000000004000000000000001C000000000000003C000000000000007C000000000000
00F800000000000001F800000000000003F000000000000007E00000000000001FC00000000000001F800000000000001F000000000000001F00000000000000
1F000000000000001F800000000000001FC000000000000007E000000000000003F000000000000001F800000000000000F8000000000000007C000000000000
003C000000000000001C000000000000000400000000000000000000000000000000000000000000000000000000000000000000000000000000000000000000
000000000000000F000000000000000F000000000000000F000000000000000F000000000000000F000000000000000F000000000000000F000000000000000F
000000000000000F000000000000000F000000000000000F000000000000000F000000000000000F000000000000000F000000000000000F000000000000000F
000000000000000F000000000000000F000000000000000F000000000000000F000000000000000F000000000000000F000000000000000F000000000000000F
000000000000000F000000000000000F000000000000000F000000000000000F000000000000000F000000000000000F000000000000000F000000000000000F
00000000000000000000000000000000000000000000000000000000000000000004000000000000001C000000000000003C000000000000007C000000000000
00F800000000000001F800000000000003F000000000000007E00000000000001FC00000000000001F800000000000001F000000000000001F00000000000000
1F000000000000001F800000000000001FC000000000000007E000000000000003F000000000000001F800000000000000F8000000000000007C000000000000
003C000000000000001C000000000000000400000000000000000000000000000000000000000000000000000000000000000000000000000000000000000000
0000000000000000000008010000000000003801C00000000000FC03F00000000000FC03F000000000007E07E000000000003E07C000000000003F0FC0000000
00001F0F8000000000000F9F0000000000000F9F00000000000007FE00000000000003FC00000000002003FC00000000003FFFFFFFC00000003FFFFFFFC00000
003FFFFFFFC00000003FFFFFFFC00000002003FC00000000000003FC00000000000007FE0000000000000F9F0000000000000F9F0000000000001F0F80000000
00003F0FC000000000003E07C000000000007E07E00000000000FC03F00000000000FC03F000000000003801C000000000000801000000000000000000000000

